vendor,Digital Commerce,Digital Knowledge Products,Digital Security,Other Digital Products,Pharmaceutical Drugs,Recreational Drugs,Total Products
BadBreed,93,91,117,19,0,1,321
GermanBorn,143,123,17,9,0,1,293
enjoymyaccounts,47,0,1,220,0,0,268
CyberGhost,102,27,22,31,0,0,182
goatchick,50,29,71,2,4,21,177
alexanderhode68,6,119,36,0,0,0,161
mdacanada,0,0,0,0,56,104,160
badbreed,87,22,37,9,0,1,156
theonlyplugyouneed,2,0,0,0,80,69,151
modestyv3,101,4,31,6,0,4,146
greatvibes,21,35,9,0,6,72,143
Trio,46,33,44,9,2,8,142
shire,0,2,0,0,63,74,139
roadrunna,0,0,0,0,8,122,130
GoldApple,108,9,5,0,0,0,122
DrunkDragon,0,101,7,0,0,0,108
westcoastsupply,0,0,0,0,22,84,106
leangreenmchine,15,0,0,0,39,45,99
thedangeroustomato,1,79,13,0,0,1,94
jeancoutu,4,2,0,0,47,38,91
